NO ./textures/north.xpm
SO ./textures/south.xpm
WE ./textures/west.xpm
EA ./textures/east.xpm
F 220,100,0
C 225,30,0

1111111111
1000000001
1011111101
1010000101
1010110101
1010010101
1000010N01
1111111111
